{
	"name": "Testowa mapa II",
	"width": 32,
	"height": 32,
	"ground": "images/grass.png",
	"objects": [
		2,2,2,2,2,0,2,0,0,0,3,0,0,2,2,2,2,2,2,2,2,2,2,2,2,2,2,2,2,2,2,2,
		2,2,2,2,2,0,0,0,2,0,3,0,0,2,2,2,2,2,2,2,2,2,2,2,2,2,2,2,2,2,2,2,
		2,2,2,2,2,0,0,0,0,0,7,4,4,4,5,0,0,0,9,10,10,10,10,10,10,10,10,11,2,2,2,2,
		2,2,2,2,2,0,0,0,0,0,0,0,2,2,3,0,0,0,12,13,13,13,13,13,13,13,13,14,2,2,2,2,
		2,2,2,2,2,0,0,0,2,2,2,2,2,2,3,0,0,0,12,13,13,13,13,13,13,13,13,14,2,2,2,2,
		0,2,2,2,0,0,0,2,2,2,2,2,2,2,3,0,0,0,12,13,13,13,13,13,13,13,13,14,2,2,2,2,
		0,0,0,0,0,2,2,2,2,2,0,2,2,0,3,0,2,0,12,13,13,13,13,13,13,13,13,14,2,2,2,2,
		0,0,0,0,0,2,2,2,2,0,0,0,2,0,3,0,0,0,12,13,13,13,13,13,13,13,13,14,2,2,2,2,
		0,0,0,0,2,2,2,2,0,0,0,0,0,0,3,0,0,0,12,13,13,13,13,13,13,13,13,14,2,2,2,2,
		0,0,2,2,2,2,2,2,0,0,0,0,0,0,3,0,0,0,12,13,13,13,13,13,13,13,13,14,2,2,2,2,
		0,2,2,2,2,2,2,2,0,0,0,0,0,0,3,2,0,0,12,13,13,13,13,13,13,13,13,14,2,2,2,2,
		0,2,2,2,2,2,2,0,0,0,2,2,0,0,3,0,0,0,15,16,16,16,16,16,16,16,16,17,2,2,2,2,
		0,2,2,2,2,2,0,0,0,0,2,2,2,0,3,0,0,2,2,2,2,2,2,2,2,2,2,2,2,2,2,2,
		0,0,2,2,2,0,0,0,0,0,0,2,2,0,3,0,0,0,0,2,2,2,2,2,2,2,2,0,2,2,2,2,
		0,0,0,0,0,0,0,0,0,0,0,2,2,2,3,2,2,0,0,2,2,2,2,2,2,2,2,0,2,2,2,2,
		0,0,0,0,0,0,0,0,0,0,0,0,2,2,3,2,2,0,0,2,2,2,2,2,2,2,2,0,2,2,2,2,
		0,0,0,0,0,0,0,0,0,0,0,0,0,2,3,2,2,0,0,2,2,2,2,2,2,2,2,0,2,2,2,2,
		0,0,0,0,0,0,2,2,0,0,0,0,0,8,6,2,2,0,0,0,0,0,0,0,0,0,0,0,2,2,2,2,
		0,2,0,0,0,2,2,2,0,0,0,2,0,3,0,0,0,0,0,0,0,0,0,0,0,0,0,0,2,2,2,2,
		0,2,2,0,0,2,2,2,2,2,2,2,0,3,0,0,0,0,0,0,0,0,0,0,2,2,0,0,2,2,2,2,
		0,0,2,2,0,2,2,8,4,5,2,2,0,3,2,2,2,2,2,2,2,2,2,0,2,2,2,0,2,2,2,2,
		0,0,0,0,0,0,2,3,2,7,4,4,4,6,2,2,2,2,2,2,2,2,2,0,0,0,0,0,2,2,2,2,
		0,0,0,0,0,0,2,3,0,0,0,0,0,0,0,0,0,0,0,2,2,2,2,2,0,0,0,0,0,0,0,0,
		0,0,0,2,2,2,2,3,0,0,0,2,2,2,2,0,0,0,0,2,2,2,2,2,0,0,0,0,0,2,0,0,
		0,0,2,2,2,2,2,3,0,0,2,2,2,2,2,2,0,0,0,2,2,2,2,0,0,0,2,0,0,2,2,0,
		4,4,4,4,4,4,4,6,0,2,2,2,2,2,2,2,2,0,0,2,2,2,0,0,0,0,2,2,0,0,2,2,
		2,2,2,2,2,0,0,0,2,2,2,2,0,0,2,2,2,2,0,2,2,2,0,0,0,2,2,2,2,2,2,2,
		0,0,0,0,0,0,0,0,2,2,2,2,0,0,2,2,2,2,0,2,2,2,0,0,0,2,2,2,2,2,2,2,
		0,2,2,2,0,0,0,0,0,0,0,0,0,0,0,2,2,0,0,2,2,0,0,0,2,2,2,2,2,2,2,2,
		0,2,2,2,2,0,0,0,0,0,0,0,0,0,0,2,0,0,0,2,2,2,0,0,2,2,2,2,2,2,2,2,
		0,0,2,2,0,0,0,0,0,0,0,0,0,0,0,0,0,0,2,2,2,0,0,0,0,2,2,2,2,2,2,2,
		0,0,0,0,0,0,0,0,0,0,0,0,0,0,0,0,0,0,2,2,2,0,0,0,2,2,2,2,2,2,2,2
	],
	"gates": [
		[0, 25, "Testowa mapa", 31, 25]
	]
}